11111111
1000E001
100C00001
100000P01
111111111