111111111111111111111111111111111111111111111111111111111111111111111111111
1000000000000000000000000000000000000000011000000C0000000000000000000000001
100000P000000000000000000000000000000000011000C0000000000000000000000000001
1000000000000000000000000000000000000000011111111111111000000000000000000C1
100000000000000000000000000000000000000000000000000111100000000000000111111
100000000000000000000000000000000000000000000000000111100000000000000000001
100000000000000000000000000000000000000000000000000111100000000000000000001
100000000000000000000000000000000000000000000000000000000000000000000000001
100000000000000000000000000C00000000000000000000000000000000000000000000001
100000000000000000000000000000000000000000000000000000000000000000000000001
100000000000000000000000000000000000000000000000000000000000000000C00000001
10000000000000000000000000000000000000000000C000000000000000000000000000001
100000000000000000000000000000000000000000000000000000000000000000000000001
100000000000000000000000000000000000000000000000000000000000000000000000001
100000000000000000000000000000000000000000000000000000000000000000000000001
100000000000000000000000000000000000000000000000000000000000000000000000001
100000000000000000000000000000000000000000000000000000000000000000000000001
111000000000000C00000000000000000000000000000000000000000000000000000000001
1111C0000000000000000000000000000000000000000000000000000000000000000000001
111110000000000000000000000000000000000000000000000000000000000000000000001
111111000000000000000000000000000000000000000000000000000000000000000000001
1111110000000000000000000000000000000000000000000000000000000000E0000000001
10C0000000000000C0000000000000000001111111111000000000000000000000000000001
11111100000000000000000000000000000C1111111111111000000000000000000000000C1
111111000000000000000000000000000011111111111000000000000000000001111111111
111111111111111111111111111111111111111111111111111111111111111111111111111