111111111111111111111111111111111
111111111111111111111111111111111
111100C0000000000C00111111111C111
11100000011110E000000000000000011
1110C0000011100000001111111100111
111000000011111110111111111101111
11100000C011111110111111111101111
111C00000011111110111111111C00111
11111000001C011110000000000000111
1111111110000000001111111100P0111
111111111111110111111111111111111
111111111111110111111111111111111
1100011100C0000111111111111111111
110C00000011111111111111111111111
110001111111111111111111111111111
111111111111111111111111111111111