111111111
10000E001
100P00001
111111111