11111111
10000001
10C00P01
11111111